10.ox
.......................
.....ooo.......ooo.....
...o.....o...o.....o...
..o........o........o..
...o...............o...
.....o...........o.....
.......o.......o.......
.........o...o.........
...........o...........
.......................
