14.ox
.............................
......oooo.........oooo......
....o......o.....o......o....
..o...........o...........o..
o...........................o
o...........................o
..o.......................o..
....o...................o....
......o...............o......
........o...........o........
..........o.......o..........
............o...o............
..............o..............
.............................
